#########
#...  . #
######  #
#     $#
# $.   #
# # ####
#@$$ $ #
#      #
####### 
